一 	one (いち, ichi, 一)
丨 	line, stick (ぼう, bō, 棒)
丶 	dot (てん, ten, 点)
丿 	bend, possessive particle no (の, no, ノ)
乙 (乚) 	second, latter (おつ, otsu, 乙)
亅 	hook, hooked stick (はねぼう, hanebō, 撥棒)
二 	two (に, ni, 二)
亠 	pot lid (なべぶた, nabebuta, 鍋蓋)
人 (亻,𠆢) 	human (ひと, hito, 人)
儿 	legs, human underneath (にんにょう, ninnyō, 人繞)
入 (𠆢) 	enter (いる, iru, 入)
八 (ハ) 	eight, eight-head (はちがしら, hachigashira, 八頭)
冂 	inverted box, window frame (まきがまえ, makigamae, 牧構)
冖 	cover, wa crown (わかんむり, wakanmuri, ワ冠)
冫 	ice, 2-stroke water (にすい, nisui, 二水)
几 	desk (つくえ, tsukue, 机)
凵 	container, inbox (うけばこ, ukebako, 受け箱)
刀 (刂,⺈) 	sword (かたな, katana, 刀)
力 	power, force (ちから, chikara, 力)
勹 	embrace, wrap frame (つつみがまえ, tsutsumigamae, 包構)
匕 	spoon hi (さじのひ, sajinohi, 匕のヒ)
匚 	box frame (はこがまえ, hakogamae, 匚構)
亡 (匸) 	dead, hiding frame (かくしがまえ, kakushigamae, 隠構)
十 	ten, complete (じゅう, jū, 十)
卜 (⼘,⺊) 	divination to (ぼくのと, bokunoto, 卜のト)
卩 (㔾) 	seal (ふしづくり, fushidzukuri, 節旁)
厂 	cliff (がんだれ, gandare, 雁垂)
厶 	private (む, mu)
又 	again, right hand (また, mata)
口 	mouth, opening (くち, kuchi)
囗 	enclosure (くにがまえ, kunigamae, 国構)
土 	earth (つち, tsuchi)
士 	scholar, bachelor (さむらい, samurai, 侍)
夂 	winter (ふゆがしら, fuyugashira, 冬頭)
夊 	winter variant (すいにょう, suinyou, 夊繞)
夕 	evening, sunset (ゆうべ, yūbe)
大 	big, very (だい, dai)
女 	woman, female (おんな, onna)
子 	child, seed (こ, ko)
宀 	roof (うかんむり, ukanmuri, ウ冠)
寸 	sun (unit of measurement) (すん, sun)
小 (⺌, ⺍) 	small, insignificant (ちいさい, chīsai, 小さい)
尢 (尤,尣) 	lame (まげあし, mageashi)
尸 	corpse (しかばね, shikabane, 屍)
屮 	sprout (てつ, tetsu)
山 	mountain (やま, yama)
巛 (川,巜) 	river (かわ, kawa)
工 	work (たくみ, takumi)
已 (己,巳) 	oneself (おのれ, onore)
巾 	cloth, turban, scarf (はば, haba)
干 	dry (ほし, hoshi)
幺 	short thread (いとがしら, itogashira, 糸頭)
广 	dotted cliff (まだれ, madare, 麻垂)
廴 	long stride (いんにょう, innyō, 延繞)
廾 	two hands, twenty (にじゅうあし, nijūashi, 二十脚)
弋 	ceremony, shoot, arrow (しきがまえ, shikigamae, 式構)
弓 	bow (ゆみ, yumi)
彐 (彑) 	pig's head (けいがしら, keigashira, 彑頭)
彡 	hair, bristle, stubble, beard (さんづくり, sandzukuri, 三旁)
彳 	step (ぎょうにんべん, gyouninben, 行人偏)
心 (忄,⺗) 	heart (りっしんべん, risshinben, 立心偏)
戈 	spear, halberd (かのほこ, kanohoko)
戸 (戶,户) 	door, house (とびらのと, tobiranoto)
手 (扌,龵) 	hand (て, te)
支 	branch (しにょう, shinyō, 支繞)
攵 (攴) 	strike, whip (のぶん, nobun, ノ文)
文 	script, literature (ぶん, bun)
斗 	dipper, measuring scoop (とます, tomasu)
斤 	axe (おの, ono, 斧)
方 	way, square, raft (ほう, hō)
无 (旡) 	have not (むにょう, munyō)
日 	sun, day (にち, nichi)
曰 	say (いわく, iwaku)
月 (⺝) 	moon, month; body, flesh (つき, tsuki)
木 	tree (き, ki)
欠 	yawn, lack (あくび, akubi)
止 	stop (とめる, tomeru)
歹 (歺) 	death, decay (がつへん, gatsuhen, 歹偏)
殳 	weapon, lance (ほこつくり, hokotsukuri)
毋 (母,⺟) 	do not; mother (なかれ-nakare; はは, haha)
比 	compare, compete (くらべる, kuraberu)
毛 	fur, hair (け, ke)
氏 	clan (うじ, uji)
气 	steam, breath (きがまえ, kigamae, 気構)
水 (氵,氺) 	water (みず, mizu)
火 (灬) 	fire (ひ, hi)
爪 (爫,⺥,⺤) 	claw, nail, talon (つめ, tsume)
父 	father (ちち, chichi)
爻 	mix, twine, cross (こう, kō)
爿 (丬) 	split wood (しょうへん, shōhen, 爿偏)
片 	(a) slice (かた, kata)
牙 	fang (きばへん, kibahen, 牙偏)
牛 (牜, ⺧) 	cow (うし, ushi)
犬 (犭) 	dog (いぬ, inu)
玄 	dark, profound (げん, gen)
王 (玉, 玊, ⺩) 	king; ball, jade (おう-ō; たま, tama)
瓜 	melon (うり, uri)
瓦 	tile (かわら, kawara)
甘 	sweet (あまい, amai)
生 	life (うまれる, umareru)
用 (甩) 	use; (throw) (もちいる, mochīru)
田 	field (た, ta)
疋 (⺪) 	bolt of cloth (ひき, hiki)
疒 	sickness (やまいだれ, yamaidare, 病垂)
癶 	footsteps (はつがしら, hatsugashira, 発頭)
白 	white (しろ, shiro)
皮 	skin (けがわ, kegawa, 毛皮)
皿 	dish (さら, sara)
目 	eye (め, me)
矛 	spear, pike (むのほこ, munohoko)
矢 	arrow (や, ya)
石 	stone (いし, ishi)
示 (礻) 	altar, display (しめす, shimesu)
禸 	track (ぐうのあし, gūnoashi)
禾 	two-branch tree (のぎ, nogi, ノ木)
穴 	cave (あな, ana)
立 	stand, erect (たつ, tatsu)
竹 (⺮) 	bamboo (たけ, take)
米 	rice (こめ, kome)
糸 (糹) 	thread, string (いと, ito)
缶 	can, earthenware jar (かん, kan)
罒 (网,罓,⺲,⺳) 	net (あみがしら, amigashira, 網頭)
羊 (⺶,⺷) 	sheep (ひつじ, hitsuji)
羽 	feather, wing (はね, hane)
耂 (老,⺹) 	old (ろう, rō)
而 	rake, beard (しかして, shikashite)
耒 	plow (らいすき, raisuki)
耳 	ear (みみ, mimi)
聿 (⺻) 	brush (ふでづくり, fudezukuri, 聿旁)
肉 (⺼,月) 	meat (にく, niku)
臣 	minister, official (しん, shin)
自 	oneself (みずから, mizukara)
至 	arrive (いたる, itaru)
臼 	mortar (うす, usu)
舌 	tongue (した, shita)
舛 	opposite (ます, masu)
舟 	boat (ふね, fune)
艮 	stopping (うしとら, ushitora, 丑寅)
色 	colour, prettiness (いろ, iro)
艹 (艸,䒑) 	grass, vegetation (くさ, kusa, 草)
虍 	tiger stripes (とらかんむり, torakanmuri, 虎冠)
虫 	insect (むし, mushi)
血 	blood (ち, chi)
行 	go, do (ぎょう, gyō)
衣 (衤) 	clothes (ころも, koromo)
西 (襾,覀) 	west (にし, nishi)
見 	see (みる, miru)
角 	horn (つの, tsuno)
言 (訁) 	speech (こと, koto)
谷 	valley (たに, tani)
豆 	bean (まめ, mame)
豕 	pig (いのこ, inoko, 猪子)
豸 	cat, badger (むじな, mujina, 狢)
貝 	shell (かい, kai)
赤 	red, bare (あか, aka)
走 (赱) 	run (はしる, hashiru)
足 (⻊) 	foot (あし, ashi)
身 	body (み, mi)
車 	cart, car (くるま, kuruma)
辛 	spicy, bitter (からい, karai)
辰 	morning (しんのたつ, shinnotatsu, 辰のたつ)
⻌ (辵,辶) 	walk (しんにゅう, shinnyū, 之繞)
邑 (⻏, 阝) 	town (阝 right) (むら, mura)
酉 	sake (rice-based alcoholic beverage) (とり, tori)
釆 	divide, distinguish, choose (のごめ, nogome, ノ米)
里 	village, mile (さと, sato)
金 (釒) 	metal, gold (かね, kane)
長 (镸) 	long, grow; leader (ながい-nagai; ちょう, chō)
門 	gate (もん, mon)
阜 (⻖, 阝) 	mound, dam (阝 left) (ぎふのふ, gifunofu, 岐阜の阜)
隶 	slave, capture (れいづくり, reidzukuri, 隷旁)
隹 	old bird (ふるとり, furutori, 古鳥)
雨 (⻗) 	rain (あめ, ame)
青 (靑) 	green, blue (あお, ao)
非 	wrong (あらず, arazu)
面 (靣) 	face (めん, men)
革 	leather, rawhide (かくのかわ, kakunokawa)
韋 	tanned leather (なめしがわ, nameshigawa)
韭 	leek (にら, nira)
音 	sound (おと, oto)
頁 	big shell (おおがい, ōgai, 大貝)
風 (𠘨) 	wind (かぜ, kaze)
飛 	fly (とぶ, tobu)
食 (飠, 𩙿) 	eat, food (しょく, shoku)
首 	neck, head (くび, kubi)
香 	fragrant (においこう, nioikō)
馬 	horse (うま, uma)
骨 	bone (ほね, hone)
高 (髙) 	tall, high (たかい, takai)
髟 	hair (かみがしら, kamigashira, 髪頭)
鬥 	fight (とうがまえ, tōgamae, 闘構)
鬯 	herbs, sacrificial wine (ちょう, chō)
鬲 	tripod, cauldron (かなえ, kanae)
鬼 	ghost, demon (おに, oni)
魚 	fish (うお, uo)
鳥 	bird (とり, tori)
鹵 	salt (ろ, ro)
鹿 	deer (しか, shika)
麦 (麥) 	wheat (むぎ, mugi, 麦)
麻 	hemp, flax (あさ, asa)
黄 (黃) 	yellow (きいろ, kīro, 黄色)
黍 	millet (きび, kibi)
黒 (黑) 	black (くろ, kuro)
黹 	embroidery, needlework (ふつ, futsu, 黻)
黽 	frog, amphibian (べん, ben)
鼎 	sacrificial tripod (かなえ, kanae)
鼓 	drum (つづみ, tsudzumi)
鼠 	rat, mouse (ねずみ, nezumi)
鼻 	nose (はな, hana)
齊 	even, uniformly (せい, sei, 斉)
歯 (齒) 	tooth, molar (は, ha)
竜 (龍) 	dragon (りゅう, ryū)
亀 (龜) 	turtle, tortoise (かめ, kame)
龠 	flute (やく, yaku)
